18 18 18 18 18 18 18 18 18 18 18 18 18 18 18 18 18 18 18 18 18 18 18 18 18 18 18 18 18 18 18 18 18 18 18 18 18 18 18 18 18 18 18 18 18 18 18 18 18 18 
18 18 18 18 18 18 18 18 18 18 18 18 18 18 18 18 18 18 18 18 18 18 18 18 18 18 18 18 18 18 18 18 18 18 18 18 18 18 18 18 18 18 18 18 18 18 18 18 18 18 
18 18 18 18 18 18 18 18 18 18 18 18 18 18 18 18 18 18 18 18 18 18 18 18 18 18 18 18 18 18 18 18 18 18 18 18 18 18 18 18 18 18 18 18 18 18 18 18 18 18 
18 18 18 18 18 18 18 18 18 18 18 18 18 18 18 18 18 18 18 18 18 18 18 18 18 18 18 18 18 18 18 18 18 18 18 18 18 18 18 18 18 18 18 18 18 18 18 18 18 18 
18 18 18 18 18 18 18 18 18 18 18 18 18 18 18 18 18 18 18 18 18 18 18 18 28 26 26 26 26 26 29 18 18 18 18 18 18 18 18 18 18 18 18 18 18 18 18 18 18 18 
18 18 18 18 18 18 18 18 18 18 18 18 18 18 18 18 18 18 18 18 18 18 18 18 24 16 16 16 16 16 25 26 26 26 26 26 26 26 26 26 26 26 26 26 26 29 18 18 18 18 
18 18 18 18 18 18 18 28 26 26 26 26 26 26 26 26 26 26 26 26 26 26 26 26 27 16 1 1 1 16 16 16 16 16 16 16 16 16 16 16 16 16 16 16 16 23 18 18 18 18 
18 18 18 18 18 18 18 24 1 1 1 1 1 1 1 1 1 1 1 1 1 1 1 1 1 1 1 1 1 16 16 16 16 16 16 16 16 16 16 16 16 16 16 16 16 23 18 18 18 18 
18 18 18 18 18 18 18 24 1 1 2 2 1 1 1 1 1 1 1 1 1 1 1 1 1 1 1 1 1 16 16 16 16 16 16 16 16 16 16 16 16 16 16 16 16 23 18 18 18 18 
18 18 18 18 18 18 18 24 1 1 1 1 1 1 1 1 20 21 21 21 21 21 21 21 22 1 1 1 1 16 16 16 16 16 16 38 39 40 16 16 16 16 16 16 16 23 18 18 18 18 
18 18 18 18 18 18 18 24 1 1 1 1 1 2 1 1 23 18 18 18 18 18 18 18 24 1 1 1 1 1 16 16 16 16 41 42 43 44 45 16 16 16 16 16 16 23 18 18 18 18 
18 18 18 18 18 18 18 24 1 1 2 1 1 1 1 1 23 18 18 18 18 18 18 18 24 1 1 1 1 1 1 16 16 16 46 47 48 49 50 16 16 16 16 16 16 23 18 18 18 18 
18 18 18 18 18 18 18 24 1 1 1 1 1 2 2 1 23 18 18 18 18 18 18 18 24 1 1 16 1 1 1 1 16 16 1 1 1 1 1 1 16 16 16 16 16 23 18 18 18 18 
18 18 18 18 18 18 18 24 1 1 1 1 1 1 1 1 23 18 18 18 18 18 18 18 24 1 1 16 16 1 1 1 16 16 1 1 1 1 1 1 1 16 16 16 16 23 18 18 18 18 
18 18 18 18 18 18 18 24 1 1 1 1 2 1 1 1 25 26 26 26 26 26 26 26 27 1 1 16 16 1 1 1 16 16 1 1 1 1 1 1 1 1 16 16 16 23 18 18 18 18 
18 18 18 18 18 18 18 24 1 1 1 1 2 1 12 10 10 10 10 10 10 10 10 10 10 10 13 16 16 1 1 1 16 16 16 16 16 1 1 1 1 16 16 16 16 23 18 18 18 18 
18 18 18 18 18 18 18 24 1 1 1 1 1 1 8 3 3 3 3 3 3 3 3 3 3 3 7 16 16 16 16 16 16 16 16 16 1 1 1 16 16 16 16 16 16 23 18 18 18 18 
18 18 18 18 18 18 18 30 21 21 21 22 1 1 14 5 5 5 5 6 3 4 5 5 5 5 15 16 16 16 16 16 16 16 16 1 1 1 16 16 16 16 16 16 16 23 18 18 18 18 
18 18 18 18 18 18 18 18 18 18 18 24 16 16 16 16 16 16 1 8 3 9 10 10 10 10 10 10 10 10 10 10 10 10 10 10 13 1 16 16 20 21 21 21 21 31 18 18 18 18 
18 18 18 18 18 18 18 18 18 18 18 24 16 16 16 16 16 16 16 8 3 3 3 3 3 3 3 3 3 3 3 3 3 3 3 3 7 1 16 16 23 18 18 18 18 18 18 18 18 18 
18 18 18 18 18 18 18 18 18 18 18 24 16 16 33 16 16 16 16 14 5 5 5 6 3 4 5 5 5 5 5 5 5 5 6 3 7 16 16 16 23 18 18 18 18 18 18 18 18 18 
18 18 18 18 18 18 18 18 18 18 18 24 16 16 1 16 1 1 16 16 16 16 16 8 3 7 16 16 16 16 16 16 16 16 8 3 7 16 16 16 23 18 18 18 18 18 18 18 18 18 
18 18 18 18 18 18 18 18 18 18 18 24 16 16 1 16 1 1 1 1 16 16 16 8 3 7 16 16 16 16 16 16 16 16 8 3 7 16 16 16 23 18 18 18 18 18 18 18 18 18 
18 18 18 18 18 18 18 18 18 18 18 24 16 16 1 16 1 1 1 1 1 1 16 8 3 7 1 1 1 1 1 16 16 16 8 3 7 16 16 16 23 18 18 18 18 18 18 18 18 18 
18 18 18 18 18 18 18 18 18 18 18 24 16 16 1 16 16 1 1 1 1 1 1 14 5 15 1 1 1 1 1 1 16 16 8 3 7 16 16 16 23 18 18 18 18 18 18 18 18 18 
18 18 18 18 18 18 18 18 18 18 18 24 16 16 1 1 16 16 16 16 16 1 1 1 1 1 1 2 1 1 1 1 1 1 8 3 7 16 16 16 23 18 18 18 18 18 18 18 18 18 
18 18 18 18 18 18 18 18 18 18 18 24 16 16 16 1 1 1 1 1 1 1 1 1 1 1 1 1 1 1 1 1 1 1 8 3 7 16 16 16 23 18 18 18 18 18 18 18 18 18 
18 18 18 18 18 18 18 18 18 18 18 24 16 16 16 16 16 16 16 16 16 1 16 16 16 16 16 1 1 1 1 1 16 16 8 3 7 16 16 16 23 18 18 18 18 18 18 18 18 18 
18 18 18 18 18 18 18 18 18 18 28 27 16 16 16 16 16 16 16 16 16 1 16 16 16 1 1 1 1 1 1 16 16 16 8 3 7 16 16 16 25 26 26 26 26 26 26 26 26 26 
18 18 18 18 18 28 26 26 26 26 27 16 16 16 16 16 16 16 16 16 16 1 16 16 1 1 1 1 1 1 1 16 16 16 8 3 7 16 16 16 16 16 16 16 16 16 16 16 16 16 
18 18 18 18 18 24 16 16 16 16 16 16 16 16 16 16 16 16 16 16 16 1 16 16 16 16 1 1 1 1 1 16 16 16 8 3 7 16 16 16 16 16 16 16 16 16 16 16 16 16 
18 18 19 18 18 24 16 16 16 16 16 16 16 16 16 16 16 16 16 16 16 1 16 16 16 16 1 1 1 1 1 16 16 16 8 3 7 16 16 16 16 16 16 16 16 16 16 16 16 16 
18 18 18 18 18 24 16 16 16 16 16 16 16 16 16 16 16 16 16 16 16 1 16 16 16 16 1 1 1 1 1 16 16 16 8 3 7 16 16 16 16 16 16 16 16 16 16 16 16 16 
18 18 18 18 18 30 21 21 21 22 1 1 16 16 16 16 16 16 16 16 16 1 16 16 16 16 1 1 1 1 1 16 16 16 8 3 7 16 16 16 16 16 16 16 16 16 16 16 16 16 
18 18 18 18 18 18 18 18 18 24 1 12 10 10 10 10 10 10 10 10 10 10 13 16 16 16 16 1 1 1 16 16 16 16 8 3 7 16 16 16 16 16 16 16 16 16 16 16 16 16 
18 18 18 18 18 18 18 19 18 24 1 8 3 3 3 3 3 3 3 3 3 3 7 16 16 16 16 16 16 16 16 16 16 16 8 3 7 16 16 16 16 16 16 16 16 16 16 16 16 16 
18 18 19 18 18 18 18 28 26 27 1 14 5 5 5 5 5 5 5 5 6 3 7 16 16 16 16 16 16 16 16 16 12 10 11 3 9 10 13 16 16 16 16 16 16 16 16 16 16 16 
18 18 18 18 18 18 18 24 16 16 16 16 16 16 16 16 16 16 16 16 8 3 7 16 16 16 16 16 16 16 16 16 8 3 3 3 3 3 7 16 16 16 16 16 16 16 16 16 16 16 
18 18 18 18 18 18 18 24 16 16 16 16 16 16 16 16 16 16 16 16 8 3 9 10 10 10 10 10 10 10 10 10 11 3 3 3 3 3 9 10 10 10 10 10 10 10 10 10 10 10 
18 18 18 18 18 18 18 30 21 21 21 21 21 21 21 21 21 22 16 16 8 3 3 3 3 3 3 3 3 3 3 3 3 3 3 3 3 3 3 3 3 3 3 3 3 3 3 3 3 3 
18 18 18 18 18 18 18 18 18 18 18 18 18 18 18 18 18 24 16 16 1 5 5 5 5 5 5 5 5 5 5 5 6 3 3 3 3 3 4 5 5 5 5 5 5 5 5 5 5 5 
18 18 18 18 18 18 18 18 18 18 18 18 18 18 18 18 18 24 16 16 16 16 16 16 16 16 16 16 16 16 16 16 8 3 3 3 3 3 7 16 16 16 16 16 16 16 16 16 16 16 
18 18 18 18 18 18 18 18 18 18 18 18 18 18 18 18 18 24 16 16 16 16 16 16 16 16 16 16 16 16 16 16 14 5 5 5 5 5 15 16 16 16 16 16 16 16 16 16 16 16 
18 18 18 18 18 18 18 18 18 18 18 18 18 18 18 18 18 24 16 16 16 16 16 16 16 16 16 16 16 16 16 16 16 16 16 16 16 16 16 16 16 16 16 16 16 16 16 16 16 16 
18 18 18 18 18 18 18 18 18 18 18 18 18 18 18 18 18 30 21 21 21 21 21 21 21 21 21 21 21 21 21 21 21 21 21 21 21 21 21 21 21 21 21 21 21 21 21 21 21 21 
18 18 18 18 18 18 18 18 18 18 18 18 18 18 18 18 18 18 18 18 18 18 18 18 18 18 18 18 18 18 18 18 18 18 18 18 18 18 18 18 18 18 18 18 18 18 18 18 18 18 
18 18 18 18 18 18 18 18 18 18 18 18 18 18 18 18 18 18 18 18 18 18 18 18 18 18 18 18 18 18 18 18 18 18 18 18 18 18 18 18 18 18 18 18 18 18 18 18 18 18 
18 18 18 18 18 18 18 18 18 18 18 18 18 18 18 18 18 18 18 18 18 18 18 18 18 18 18 18 18 18 18 18 18 18 18 18 18 18 18 18 18 18 18 18 18 18 18 18 18 18 
18 18 18 18 18 18 18 18 18 18 18 18 18 18 18 18 18 18 18 18 18 18 18 18 18 18 18 18 18 18 18 18 18 18 18 18 18 18 18 18 18 18 18 18 18 18 18 18 18 18 
18 18 18 18 18 18 18 18 18 18 18 18 18 18 18 18 18 18 18 18 18 18 18 18 18 18 18 18 18 18 18 18 18 18 18 18 18 18 18 18 18 18 18 18 18 18 18 18 18 18 
